# Resources from graph.properties
alreadyConnected=节点已链接
cancel=取消
close=关闭
collapse-expand=折叠/展开
containsValidationErrors=发生错误了
done=完成
doubleClickOrientation=双击编辑
error=错误
errorSavingFile=保存失败
ok=确定
updatingDocument=正在更新文档，请稍后
updatingSelection=正在更新，请稍等
# Custom resources
about=关于
actualSize=实际大小
add=添加
addLayer=新增层
addProperty=新增属性
addToExistingDrawing=添加到当前区域
addWaypoint=添加路径
advanced=Advance
align=居中
alignment=对齐
allChangesLost=放弃修改
angle=Angle
apply=确定
arc=Arc
arrange=Arrange
arrow=Arrow
arrows=Arrows
automatic=自适应
autosave=自动保存
autosize=自适应大小
background=背景
backgroundColor=背景色
backgroundImage=背景图
basic=Basic
block=区块
blockquote=引用
bold=加粗
border=边框
borderWidth=边宽
borderColor=边框颜色
bottom=下
bottomAlign=居下
bottomLeft=下左
bottomRight=下右
bulletedList=无序列表
cannotOpenFile=打开失败
center=中间
change=修改
changeOrientation=修改方向
circle=Circle
classic=Classic
clearDefaultStyle=清除默认样式
clearWaypoints=清除路径
clipart=Pictures
collapse=折叠
collapseExpand=折叠/展开
collapsible=可折叠
comic=Comic
connect=Connect
connection=Connection
connectionPoints=Connection points
connectionArrows=Connection arrows
constrainProportions=Constrain Proportions
copy=复制
copyConnect=Copy on Connect
copySize=复制大小
create=创建
curved=Curved
custom=Custom
cut=剪切
dashed=Dashed
decreaseIndent=Decrease Indent
default=Default
delete=删除
deleteColumn=删除列
deleteRow=删除行
diagram=Diagram
diamond=Diamond
diamondThin=Diamond (thin)
direction=方向
distribute=Distribute
divider=Divider
documentProperties=文档属性
dotted=Dotted
drawing=Drawing{1}
drawingEmpty=Drawing is empty
drawingTooLarge=内容太多了
duplicate=克隆
duplicateIt=克隆 {1}
east=东
edit=编辑
editData=修改数据
editDiagram=修改图形
editImage=修改图片
editLink=修改链接
editStyle=修改样式
editTooltip=修改提示
enterGroup=输入组
enterValue=输入值
enterName=输入名称
enterPropertyName=输入属性名
entityRelation=对象关系
exitGroup=退出组
expand=展开
export=导出
extras=其它
file=文件
fileNotFound=找不到文件
filename=文件名
fill=填充
fillColor=填充色
fitPage=单页
fitPageWidth=页宽
fitTwoPages=双页
fitWindow=全屏
flip=Flip
flipH=Flip Horizontal
flipV=Flip Vertical
font=Font
fontFamily=字体
fontColor=字体颜色
fontSize=字体大小
format=格式
formatPanel=属性面板
formatPdf=PDF
formatPng=PNG
formatGif=GIF
formatJpg=JPEG
formatSvg=SVG
formatXml=XML
formatted=Formatted
formattedText=Formatted Text
gap=Gap
glass=Glass
general=General
global=全局
gradient=Gradient
gradientColor=Color
grid=栅格
gridSize=栅格尺寸
group=Group
guides=参考线
heading=标题
height=高
help=帮助
hide=隐藏
hideIt=隐藏 {1}
hidden=Hidden
home=首页
horizontal=Horizontal
horizontalFlow=Horizontal Flow
horizontalTree=Horizontal Tree
html=HTML
id=编号
image=Image
images=Images
import=导入
increaseIndent=增加缩进
insert=插入
insertColumnBefore=左边插入
insertColumnAfter=右边插入
insertHorizontalRule=插入水平线
insertImage=插入图片
insertLink=插入链接
insertRowBefore=上面插入
insertRowAfter=下面插入
invalidName=错误的名字
invalidOrMissingFile=错误或无效的文件
isometric=等距
italic=斜体
layers=图层
landscape=Landscape
laneColor=Lanecolor
layout=图层
left=左
leftAlign=居左
leftToRight=从左到右
line=线
link=链接
lineJumps=Line jumps
lineend=终点
lineheight=线高
linestart=起点
linewidth=线宽
loading=加载中...
lockUnlock=锁定/解锁
manual=帮助文档
middle=中间
misc=Misc
more=更多
moreResults=查看更多
move=移动
moveSelectionTo=移到 {1}
navigation=导航
new=新建
noColor=无颜色
noFiles=找不到文件
noMoreResults=没有更多了
none=空
noResultsFor=没有找到 '{1}'
normal=正常
north=北
numberedList=有序列表
opacity=透明度
open=打开
openArrow=开放箭头
openFile=打开文件
openLink=打开链接
openSupported=只支持[.XML]文件
openInNewWindow=新窗口打开
openInThisWindow=当前窗口打开
options=选型
organic=基础的
orthogonal=直角
outline=外边线
oval=Oval
pages=Pages
pageView=页面视图
pageScale=页面缩放
pageSetup=页面打开方式
panTooltip=Space+Drag 滚动
paperSize=页面大小
paste=粘贴
pasteHere=粘贴到这里
pasteSize=粘贴尺寸
pattern=匹配...
perimeter=周长
placeholders=占位符
plusTooltip=单击链接并复制
portrait=详情
position=位置
posterPrint=海报模式打印
preview=预览
print=打印
radialTree=光线式
redo=恢复
removeFormat=清除样式
removeFromGroup=从组中删除
removeIt=删除 {1}
removeWaypoint=删除路径
rename=重命名
renameIt=重命名 {1}
replace=替换
replaceIt={1} 已存在，确定替换吗？
replaceExistingDrawing=替换图形
reset=重置
resetView=重置视图
reverse=反转
right=右
rightAlign=居右
rightToLeft=从右到左
rotate=旋转
rotateTooltip=选中拖住缩放
rotation=旋转
rounded=Rounded
save=保存
saveAs=另存为...
saved=已保存
scrollbars=滚动条
search=搜索
searchShapes=搜索形状
selectAll=全选
selectEdges=选择所有线条
selectFont=选择字体
selectNone=取消选择
selectVertices=选择所有节点
setAsDefaultStyle=设为默认样式
shadow=阴影
shape=形状
sharp=Sharp
sidebarTooltip=
simple=简洁
simpleArrow=简洁箭头
size=尺寸
solid=实线
sourceSpacing=间距
south=南
spacing=间距
straight=直的
strokeColor=线条颜色
style=样式
subscript=子脚本
superscript=父脚本
table=表格
targetSpacing=对象间距
text=文本
textAlignment=文本对齐
textOpacity=文本透明度
toBack=置底
toFront=置顶
tooltips=提示
top=上
topAlign=居上
topLeft=上左
topRight=上右
transparent=透明
turn=旋转90°
uml=UML
underline=下划线
undo=撤销
ungroup=未设置组
url=URL
untitledLayer=未命名
vertical=垂直
verticalFlow=Vertical Flow
verticalTree=Vertical Tree
view=视图
waypoints=路径
west=西
width=宽
wordWrap=文字换行
writingDirection=书写方向
zoom=缩放
zoomIn=缩小
zoomOut=放大
